-----------########
-----------#--....#
############--....#
#----#--$-$---....#
#-$$$#$--$-#--....#
#--$-----$-#--....#
#-$$-#$-$-$########
#--$-#-----#
##-#########
#----#----##
#-----$---##
#--$$#$$--@#
#----#----##
###########
