----------#######
----------#--...#
------#####--...#
------#------.-.#
------#--##--...#
------##-##--...#
-----###-########
-----#-$$$-##
-#####--$-$-#####
##---#$-$---#---#
#@-$--$----$--$-#
######-$$-$-#####
-----#------#
-----########