-------#####
-#######---##
##-#-@##-$$-#
#----$------#
#--$--###---#
###-#####$###
#-$--###-..#
#-$-$-$-...#
#----###...#
#-$$-#-#...#
#--###-#####
####
