######--###
#..--#-##@##
#..--###---#
#..-----$$-#
#..--#-#-$-#
#..###-#-$-#
####-$-#$--#
---#--$#-$-#
---#-$--$--#
---#--##---#
---#########