----#####
----#---#
----#$--#
--###--$##
--#--$-$-#
###-#-##-#---######
#---#-##-#####--..#
#-$--$----------..#
#####-###-#@##--..#
----#-----#########
----#######