-###--#############
##@####-------#---#
#-$$---$$--$-$-...#
#--$$$#----$--#...#
#-$---#-$$-$$-#...#
###---#--$----#...#
#-----#-$-$-$-#...#
#----######-###...#
##-#--#--$-$--#...#
#--##-#-$$-$-$##..#
#-..#-#--$------#.#
#-..#-#-$$$-$$$-#.#
#####-#-------#-#.#
----#-#########-#.#
----#-----------#.#
----###############