--####
--#--###########
--#----$---$-$-#
--#-$#-$-#--$--#
--#--$-$--#----#
###-$#-#--####-#
#@#$-$-$--##---#
#----$-#$#---#-#
#---$----$-$-$-#
#####--#########
--#------#
--#------#
--#......#
--#......#
--#......#
--########